0000000000000000000
0000000000000000000
0000002222222200000
0000021311111200000
0022222122221222222
0023131133B13121122
022311223322C3333K2
02213B1133331121122
0222312212211122220
02223322122D2200000
02113322122D2222200
02121202P2211111200
021112022221E111200
021K120000211111200
0212120000222222200
02C1120000000000000
0222220000000000000
0000000000000000000
0000000000000000000