0000000000000000000
0000000000000000000
222222222222222222
2K11111111111111112
2111333333331111312
2111111111111111312
2111111222222111312
211111122P2233c1312
2111111221223311112
2111111111111111112
2111111111111111112
2111111222111122212
21111111113333D1212
212221122211112E212
2122133111111122212
2111111111111111112
2222222222222222222
0000000000000000000
0000000000000000000