0000002222022222200
000000211222112P200
0000002131113121200
0000022212221221200
2222221132221113220
2112221212121221220
2131113131323113120
2131111212C21221220
2133233131313121222
2133233212121221112
21332211313131222D2
213322112212112E112
2133122222222222222
2111K20000000000000
2222220000000000000
0000000000000000000
0000000000000000000
0000000000000000000
0000000000000000000