0000000000000000000
0000000000000000000
0000000000000000000
0000000000000000000
0000222222220222000
00002111111202E2000
0222212222120212000
02P1112002122212000
0222222002111112000
0000000002222222000
0000000000000000000
0000000000000000000
0000000000000000000
0000000000000000000
0000000000000000000
0000000000000000000
0000000000000000000
0000000000000000000
0000000000000000000