0000000000000000000
0000000000000000000
0000000000000000000
0000000000000000000
0000000000000000000
0222220000002222200
0211122222222111200
0212122111122121200
0211111111111111200
0221222211222212200
0021202111120212000
002P202111c202E2000
0022202222220222000
0000000000000000000
0000000000000000000
0000000000000000000
0000000000000000000
0000000000000000000
0000000000000000000