0000000000000000000
0000000000002222000
00000000222221b2220
00000000233T331DE20
000000002K221311220
00000000211113B2000
0000002221222220000
22222221133g2000000
2111112111112000000
2T3221211g112000000
22B1012111112000000
222K112g111P2000000
2111112222222000000
2CD1112000000000000
2222222000000000000
0000000000000000000
0000000000000000000
0000000000000000000
0000000000000000000