0000000000000000000
0000000000000000000
0000000000000000000
0222222222222222200
0211111111111111220
0212222131113313120
021311C111111111120
0213222221222212200
021322222E200212000
02132222222002P2000
0211222220000222000
0211133c20000000000
0212111120000000000
0211122220000000000
0222220000000000000
0000000000000000000
0000000000000000000
0000000000000000000
0000000000000000000