0000000000000000000
0000000000000000000
0000000000000000000
0000000000000000000
0000000000000000000
2222222222222200000
2111111111111200000
2122222222221222200
2122E11111113111200
2122222222221221200
212222222222P221200
2122222222222221200
212111122C122221200
2111111111111111200
2222221111112222200
0000022222222220000
0000000000000000000
0000000000000000000
0000000000000000000