0000000000000000000
0000000000000000000
0000000000000000000
0000022200000022200
000002E20000002P200
0000221200222221200
0000211222211221200
0000212111111111200
0000211122221111200
0000222220022222200
0000000000000000000
0000000000000000000
0000000000000000000
0000000000000000000
0000000000000000000
0000000000000000000
0000000000000000000
0000000000000000000
0000000000000000000