0000000000000000000
0000000000000000000
0000000000000000000
0000000000000000000
0000000000000000000
0000000000000000000
0000000000000222000
00000000000002P2000
0000002222222212220
0002222111111111120
0002E111111C1111120
0002222211111111120
0000000222222222220
0000000000000000000
0000000000000000000
0000000000000000000
0000000000000000000
0000000000000000000
0000000000000000000