0000000000000000000
0000000000000000000
0000000000000000000
1111111111111111111
11111111111111g1111
1111111111111111111
1111111121111G11111
1111111121111B11111
11P11T112111T1E1111
1111111121111111111
1111111121111111111
1111111121111111111
1111111121111111111
1111111111111111111
1111111111111111111
0000000000000000000
0000000000000000000
0000000000000000000
0000000000000000000